+-+-+-+-+-+-+-+-+-+-+-+-+-+-+-+-+-+-+-+-+-+---+-+
| | |                             |             |
+ + + +-+-+-+-+-+-+-+-+-+-+-+-+-+ +-+-+-+-+-+-+ +
| | |     | |                   |             | |
+ + + + + + + +-+-+-+-+-+-+-+-+ +-+-+-+-+-+-+ + +
| | | | | | |   |             |             | | |
+ + + + + + + + + +-+-+-+ +-+ +-+-+-+-+-+ + + + +
| | | | | | | | |       | |             | | | | |
+ + + + + + + + +-+-+-+-+ +-+-+-+-+-+-+ + + + + +
| | | | | | | |         | |           | | | | | |
+ + + + + + + +-+-+-+-+ + + +-+-+-+ + + + + + + +
| |     | | | | |       | |       | | | | | | | |
+ + +-+-+ + + + + +-+-+-+ +-+-+-+ + + + + + + + +
| | |   | | | | | |             | | | | | | | | |
+ + + + + + + + + +   +-+-+-+   + + + + + + + + +
| |   | | | | | | |   |     |   | | | | | | | | |
+ +-+-+ + + + + + +   +     +   + + + + + + + + +
|     | | | | | | |      M      | | | | | | |   |
+-+-+ + + + + + + +   +     +   + + + + + + + +-+
>   | | | | | | | |   |     |   | | |   | | |   X
+ +-+ + + + + + + +   +-+-+-+   + + + +-+ + +-+-+
|   | | | | | | | |             | | | |   | |   |
+ + + + + + + + + +-+-+-+ +-+-+-+-+ + + +-+ + + +
| | | | | |   |         | |           | |   | | |
+ + + + + + +-+-+-+-+-+-+ + + +-+-+-+-+ + +-+ + +
| | | | | |             | | |         | | | | | |
+ + + + +-+-+-+-+ +-+-+-+ + +-+-+-+-+-+ + + + + +
| | | | |                 | |           | | | | |
+ + + + +-+-+-+-+-+-+-+-+-+ +-+-+-+-+-+-+ + + + +
| | | |                   | |             | | | |
+ +-+ + +-+-+-+-+ +-+-+-+-+ + + +-+-+-+-+-+ + + +
|     | |                   | |             | | |
+ +-+ +-+-+-+-+-+-+-+-+-+-+-+ +-+-+-+-+-+-+-+-+ +
|   |                                           |
+-+-+-+-+-+-+-+-+-+-+-+-+-+-+-+-+-+-+-+-+-+-+-+-+