+-+-+-+-+
>     |U|
+ +-+ +-+
| | |   |
+ + +-+-+
|   |   |
+ +-+-+ +
|       X
+-+-+-+-+